talk: 10分のタイマーを10時間でセットした	はははっは！
talk: [|1人で][ホラー|恋愛|]映画を見た	次は一緒に見よ
talk: 1人暮らしが終わって悲しい	社会人になったら又一人暮らしできるよ。
talk: DM[が|]うざい	ブロックしちゃえ
talk: ESの[期限|〆切]間違えた	違う企業でも似てるような会社あるはずだよ！
talk: Gだ	逃げるぞ
talk: Gに遭遇した	戦闘態勢！
talk: [JCB|カード][が|]使えなかった	そんなお店願い下げだわ
talk: LINEの通知[が|]こない	設定だね
talk: [SNSで|]悪口を書かれた	無視が一番だよ
talk: SNSをやめたい	私もSNSはやっていない
talk: SNSを使いこなせない	難しいよね
talk: [Suica|パスモ][を|]忘れた	切符チャレンジ！
talk: [Twitterで|]ポエム書く人痛い	地味にそのポエム響いたりするよね
talk: [Twitterで|]悪口書いた	それはやめときな！
talk: V6[が|]解散した	寂しいね
talk: 〆切[が|]迫ってる	あと少し、頑張って！
talk: いいね[が|]もらえない	時間帯じゃない？
talk: いじめられている	相談できる人に相談しよう
talk: おしゃべりかも	誰とでも話せるのは凄い！
talk: おみくじで大凶[が|]出た	ある意味ラッキー！
talk: お互いに無視しあっている	仲直りした方が良いと思う
talk: お化け屋敷はダメでしょ	頑張って
talk: お土産で買ったものが地元でも売っていた	お土産は思い出なんだから、そんなに落ち込まないで！
talk: お寿司にわさび入ってた	大人の階段登った！
talk: お店[が|]定休日だった	他のお店探してみよう
talk: お店[が|]閉まってる	そんな時もあるよ
talk: お店で頼んだ飲み物がまずかった	店員さんに言ってみよう
talk: お弁当忘れた	一緒に買いに行こう
talk: お気に入りの服[が|]汚れちゃった	何とかしてきれいにできないかな…
talk: お気に入りの服汚した	洗濯すれば落ちるかも
talk: お申し出受けた	堂々としてれば大丈夫
talk: お皿を割ってしまった	怪我がなくてよかった！手袋とかで滑らないように気をつけよう!
talk: お腹[が|]痛い	大丈夫？
talk: お腹[が|][空いた|すいた]	キットカット食べる？
talk: お腹[が|]減った	キットカット食べる？
talk: お菓子[が|]おいしくてやめられない	おいしいからしかたない
talk: お財布忘れた	今日は奢ってもらおう
talk: お財布落とした	交番へlet's go！
talk: お金[が|]たまらない	バイトを増やそう
talk: お金[が|]ない	節約力上がるね
talk: お金[が|]ないことに気づいた	空っぽの財布が現れた！
talk: お金が全然たまらない	えいえいおー！
talk: お金[が|]全然ない	それは頑張れ
talk: お金[が|]少し足りない	お金が浮いたよ！
talk: お金[が|]無い	一緒にバイト始めよう！
talk: お金[が|]返ってこない	それはやばい。催促すべきじゃない？
talk: お金を使い過ぎた	稼げ稼げ
talk: お金全部使っちゃった	また稼げば良いよ
talk: お金貯まるかな	貯金箱あるから大丈夫！
talk: お隣さんとうまく話せない	練習していこう
talk: お風呂[が|]壊れた	銭湯に入りに行こう
talk: お風呂のボタン押し忘れた	あー！私もたまにやるやつ！
talk: お風呂の栓[が|]外れてた	それめっちゃショックなやつ…
talk: お風呂の栓をせずに沸かしてしまった	これから気を付けれれば水道ガス代も報われるよ
talk: お風呂入りたくない	うちも入ってない、朝までに入ればオッケー
talk: かぐや姫が月に帰った	実家に帰っただけだよ。また帰ってくるよ。
talk: かわいい子	天使が舞い降りたと思った
talk: けがをした	けがだけで済んでよかったね
talk: こけた	誰も覚えてないよ
talk: これ分かんない	教えてあげるよ
talk: これ食べられない	食べてあげるよ
talk: ご飯[が|]冷たい	１０階にレンジあるよ
talk: ご飯を炊く時の水の分量を間違えた	いろんなご飯の硬さを楽しもう
talk: ご飯を食べ忘れた	次食べるご飯はおいしいだろうなあ
talk: ご飯食べるタイミング逃した！	早く寝て朝早く食べよ！
talk: ささくれ[が|]できた	保湿しよう
talk: さぼりすぎてる	休むことも大切
talk: しょっちゅう忘れ物する	気を付けよう
talk: しょっちゅう転ぶ	気を付けよう
talk: しんどい	推しの為に頑張って
talk: じぶんはなにもできない	そんなことないよ！
talk: すぐに諦めてしまう	周りの人に頼ろう
talk: すっぽかした	そことは縁が無かったんだよ
talk: ずっとゲームをしてしまう	時間決めてやる
talk: ずっと眠い	私もそうなんだよね、お昼寝するといいらしいよ!
talk: ずっと見てしまう	スクリーンタイム機能を使おう
talk: うんち踏んだ	運がついてくるよ
talk: ついてない	毎日ラッキーだったら面白くなくない？
talk: ついチェックしてしまう	私もよくやっちゃうよー！
talk: つらいことなさそうに見えてしまう	周りをハッピーにしてるね
talk: いじけてないかな…	大丈夫！
talk: 名前を勝手に使ったこと怒ってるかな…	怒ってなかったよ！
talk: どうしよう	基本何とかなるから、とりま落ち着け？
talk: どこかに出かけたい	時間調整して!
talk: どっちに進めばいいか分からない	心のコンパスに従おう！
talk: なんだか友達にハブられてるような、	考えすぎじゃない？
talk: におわせ[が|]つらい	見なきゃ良い
talk: にらまれた	無視しよ
talk: にわか雨にあった	風邪ひかないようにね
talk: ばいばい	またね
talk: ひったくりにあった	荷物はそのうち戻ってくるよ
talk: ぴえん	ぱおん
talk: ほしいもの[が|]買えなかった	次はちゃんと予約しよう
talk: ぼんやりとした不安	夏目漱石と同じ悩みだね、まずはどうして不安なのかを考えてみたら？
talk: みんな見てるところで1人でこけた	そんな時もある、次はいいことあるよ”
talk: めっちゃフォロワー減った	ただみんながインスタ辞めただけじゃない？
talk: めっちゃ噛みまくった	わかる、緊張すると噛むよね…
talk: もうすぐ休み	自分の好きなことできるね
talk: もっと成績をよくしたい	もっと勉強しよう
talk: やってみたいけど勇気[が|]出ない	チャレンジしてよくないことはあまりないからやってみるのがいい
talk: やばい	いい意味？悪い意味？
talk: やばい課題	教えてあげるよ
talk: やらかした	君が思っているより、他人は何とも思わないぜ？気にせず挽回が大切。
talk: やりたいことがわからない	色々なことに興味を持ってみよう
talk: やりたくない仕事を続けている	頑張っているね
talk: やる気[が|]出ない	一旦休憩しよ！
talk: やる気[が|]起きない	一緒にやろう
talk: よく怒られてしまう	それだけ期待されてるってことだね
talk: わからん	教えてあげよう
talk: アイス溶けてた	もう一回買おう！
talk: アイディアを貰った	その考え神かよ
talk: アウター欲しいけど高くて買えない	お年玉まで待とう
talk: アカウント[が|]凍結した	問い合わせたらいいんじゃない
talk: アカウントを作りたい	調べよう
talk: アクセルとブレーキ間違えた	瞬発力！！
talk: アニメの推し[が|]亡くなった	それは苦しいね、、
talk: アニメの推し[が|]死んじゃった	あるよね
talk: イケメン見つけた	最高じゃん！
talk: イライラする	寝ればおさまる。
talk: イルミネーション見に行きたいのに混んでる、	混んでるときに行った方が味があるよ
talk: インターン[が|]通らない	合わないってことであきらめな
talk: インターン忘れてた	そこまでの会社だったってことだよ
talk: インターン落ちた	応募しただけえらい
talk: インフルエンザ辛い	お大事に
talk: エアコンを消し忘れた	帰ったら快適だね
talk: オンラインでマイクがonになってた	とりあえず下手なこと話してなければセーフ!!
talk: オンライン授業嫌だ	通勤ラッシュに乗らなくて済むよ！
talk: オートロックで追い出された	服着てただけまし
talk: カギ閉めたっけ	家戻る？
talk: カップルの惚気[が|]多すぎる	ほほえましいね
talk: カレー作ろうと思ったのにルーがなかった	ポトフに変更しよう
talk: ガシャポンで欲しいもの[が|]出なかった	きっと今は運を溜めている段階だから落ち込まないで！
talk: ガチャ[が|]外れた	どんまい
talk: ガチャで神引きしたのが羨ましい	あなたもいつか神引きできるよ
talk: ガチャガチャで同じのが3回も出た	メルカリで売れるよ！
talk: ギャグ[が|]寒い	どんなギャグ？？
talk: クリぼっち	一人の時間も大事
talk: クレーマー[が|]きた	客だからって偉そうだよね
talk: クレーム[が|]来た	クレーム対応お疲れ様です
talk: グッズ売り切れ	それはつらい
talk: グループ内で自分以外で遊んでた	そのグループなんて友達じゃない！
talk: ケーキ[が|]売り切れちゃう	残りものには福がある
talk: ケータイの画面を割った	ケガしないように気を付けてね
talk: ゲーム[が|]攻略できない	地道に進めよう
talk: ゲームで全ロスした	ご愁傷様です
talk: ゲームのデータ飛んだ	一からやり直そ
talk: ゲームのログイン忘れた	それめっちゃ悔しいよね
talk: ゲームをぶっちしてしまった	どんまい…もっといい結果にできるよ
talk: ゲーム機[が|]壊れた	それは最悪だね、データとか大丈夫？？
talk: コップを落としてしまった	新しいものを買おう
talk: コロナ	それ全世界共通の悩み。解決できた君はノーベル賞
talk: コロナこの収束するかな	落ち着くといいね
talk: コロナ太りした	一緒に運動しよう！
talk: コンサートの抽選に落ちた	そっか…次当たるよきっと！
talk: コンタクトなくした	裸眼の世界を楽しもう！
talk: コンタクトを落として何も見えない	頑張って
talk: コンタクト落とした	今日はメガネでイメチェンだ！
talk: コーディングテスト[が|]本当にできない	あれは難しい
talk: ゴキブリに遭遇した	ゴキジェットで頑張って!
talk: ゴキブリを仕留め損ねた	もしかしたら家の外に行ったかもよ
talk: ゴミ出し忘れた	やっちゃった〜
talk: ゴミ箱をひっくり返した	だるいね
talk: サンタさん[が|]来ない	大人になったね
talk: サークルの部員[が|]来ない	連絡してみようか
talk: シフト[が|]急遽入った	その分稼げるよ
talk: シフト入ってないのにバイト行っちゃった	そんな日もあるよ！
talk: シャンプーとリンスを間違えて何回も洗ってしまった	より清潔になったと思おう！
talk: ジムに行きたいのにちゃんと通えるか不安でいけない	やる気次第
talk: ジュースこぼした	( ･᷄∀･᷅ )
talk: ジュースをこぼした	ティッシュあるよ
talk: スイーツを食べられた	名前を書いておこう
talk: スタバの新作[が|]売り切れてた	カロリー摂取抑えられたね
talk: スタバの新作終わった	来年になれば忘れるよ
talk: スタバの新作高すぎ	幸せの代金
talk: ストーリーに講義資料[が|]写ってる	流出はダメだよ
talk: ストーリー非表示にされてた	自分のも非表示にしておこう
talk: スマホ[が|]割れた	買い替えの時期かも
talk: スマホ[が|]壊れた	新しいの買おう
talk: スマホ[が|]繋がらない	気をつけてね
talk: スマホの充電[が|]切れた	勉強に集中できるね
talk: スマホの動作が変	たまにあるよね
talk: スマホの画面[が|]割れた	ちゃんと修理できるといいね…
talk: スマホを忘れた	電気代が浮く
talk: スマホを無くした	えっ？！やばいやん・・・
talk: スマホを落とした	アプリで探せないかな？
talk: スマホ使えない	スマホ使えない時も意外と楽しいよ？
talk: スマホ割れた	そろそろ買い替え時かも
talk: スマホ忘れた	スマホないときついよねー
talk: スーツにジュースこぼした	クリーニングに出そう
talk: スーツケースの鍵なくした	あかなくてもどうにかなる
talk: ズボンのファスナー[が|]開いてた	どんまい、気づいてない人も多いと思うよ
talk: センター[が|]変わっちゃった	次のセンター誰だろうね
talk: タンスの角に足の小指をぶつけた	お大事に
talk: ダイエット[が|]続かない	なかなか難しいよね、、
talk: ダイエットをしたいのに食べてしまう	めっちゃわかる
talk: ダブルブッキングをした	きっと、なんとか調整できるよ！
talk: ダンス[が|]覚えられない	練習あるのみ！たくさん練習頑張って
talk: チケット[が|]外れた	きっと次は当たるよ
talk: チケットなくした	問い合わせればとうにかなる
talk: チケットの抽選期間[が|]終わっていた	きっと運が溜まっているよ！
talk: チケットの販売期間[が|]終わっていた	これからきちんとチェックして忘れないようにすればOK!
talk: チケット取れなかった	次とれるよ
talk: チケット売り切れてた	ライヴビューイングや配信を待とう。
talk: チケット忘れた	係の人に正直に話そう
talk: ツリー飾るの面倒だな	飾った後の感動は頑張った人にしか味わえないよ
talk: ティッシュ[が|]洗濯物の中に	私もよくやっちゃう…
talk: テキスト忘れた	そんな日もある
talk: テスト0点だった	伸び代だらけ！
talk: テスト[が|]できるか分からない	予習を頑張ろう！
talk: テストで0点とった	次がある！
talk: テストでケアレスミスをした	しょうがないよ
talk: テストの結果[が|]悪かった	そういう時もあるよ!次、頑張ろう!
talk: テストの裏に気[が|]付かなかった	表は全部解けたの？
talk: テスト大丈夫かな	正直不安を感じている時点で大丈夫
talk: テスト大丈夫だったかな	終わったことを気にするな！
talk: テスト忘れてた	何とかなるさ
talk: テスト怖い	怖いよね
talk: テスト落ちた	次がんばれ
talk: テスト赤点	知ってた？アインシュタインは物理の成績悪かったんだよ！あれ、ガリレオだっけな？
talk: データ[が|]吹っ飛んだ	それは辛すぎる、次はバックアップしとこう…
talk: データ飛んだ	ゴミ箱確認！！！
talk: デート忘れてた	次に挽回しな
talk: トイレ[が|]混雑していた	女子はねぇ…
talk: トイレにスマホを忘れた	まだあるといいね
talk: トイレめっちゃ並んでる	ドンマイ！
talk: トイレットペーパーをきらした	ペーパーがなくなったことに気づけたのがえらい
talk: ドアの鍵をし忘れた	今日は早く帰ろっか
talk: ドタキャンされた	そのことはもう遊ぶのやめよう
talk: ドラマ見逃した	見逃し配信をチェック！
talk: ナルシスト	一番冷めるやつやん！
talk: ニキビ[が|]痛い	バランスよく食べよう
talk: ニキビできた	皮膚科行こ
talk: ネガティブになってしまう	気楽に行こう
talk: ネットで買った服が思っていたものと違う	それは悲しい
talk: ノンスタ井上	(-_-;)
talk: ハブられた	私がいるよ！
talk: バイキング行きそびれた	欲張って食べて胃もたれせずに済んだね
talk: バイトあること忘れた	社会人だと遅刻は許されないから、今のうちだよ！
talk: バイトあるのに制服忘れた	バイトの友達に貸してくれないか聞いてみよう
talk: バイトでお客さんに水かけた	謝ったら許してくれるよ！
talk: バイトでミスしないかな	きっと大丈夫！
talk: バイトで失敗した	次は気を付けよう
talk: バイトで怒られた	次から頑張ろう
talk: バイトに落ちた	コロナだからしょうがない
talk: バイトの時間を1時間間違えた	1時間早く入れてもらっちゃおう！
talk: バイトミスった	所詮バイトなんだからそこまで気にせんでええ。
talk: バイト先での上司との会話	年上の人と話すのはいい経験だよ
talk: バイト先に馴染めない	私のバイト先どう？
talk: バイト先のシフト[が|]減った	他を探してみてもいいかも
talk: バイト先の人と合わない	仕事に集中して放っておけばOK
talk: バイト先の人と大学で会話したとき	身構えますよね
talk: バイト先の先輩[が|]面倒臭い	聞き流そう
talk: バイト落ちた	向いてなかったんだよ
talk: バイト行きたくない	お金のために頑張ろう
talk: バイト長引いた	給料日の自分が喜ぶ！
talk: バカって言われた	バカっていう方がバーカ！
talk: バカにするように笑われた	それは嫌だね
talk: バカ丸出し	バカの方が楽しいよ！
talk: バス[が|]目の前で行っちゃった	仕方ない、気長に次の待とう！
talk: バス[が|]目の前で行ってしまった	次のバスまで待とう
talk: バズった	最高！
talk: バック忘れた	よくあるよね
talk: バッドエンドの映画を見た	悲しいね、、
talk: バナナですべった	そんなバナナ🍌
talk: パスモ[が|]なくなった	見つかるといいね
talk: パソコン[が|]壊れた	直し方調べよう
talk: パソコンのデータ[が|]全部消えた	次からバックアップを取るようにすればOK
talk: パソコンのデータ[が|]消えた	なんとか復旧できないかな、、、
talk: パソコンの動作が変	再起動したら？
talk: パニック	まずは落ち着いて深呼吸。
talk: パンクした	修理修理ー
talk: パンクした	腕力鍛えられるね
talk: パーマかけたけど全然かからなかった	その美容院には2度と行かないようにしよう
talk: ヒール折れた	韓国ドラマあるある
talk: ピアス穴[が|]膿んだ	お薬塗るといいよ
talk: ピアノの発表会がある	いつも通りやれば大丈夫
talk: ピンチ	今助ける！ヘリを待つんだ！
talk: フォロワー[が|]うるさい	ミュートすればいいんじゃない
talk: フォロワー[が|]伸びない	通信が重たくならずに済むね
talk: フォロワー[が|]増えない	そのうち増えるよ
talk: フォロワーにブロックされた	あなたとは相性が合わなかっただけ
talk: フォロワー増えた	いいね！！！
talk: フォロワー増えない	徐々にがんばろ
talk: フォロワー少なすぎ	私がいるだろ
talk: フォロー外された	きっと間違っちゃったんだよ
talk: フラれた	いやいやいや、恋愛できてるだけええやん
talk: フードコートで席[が|]あいてない	相席でもいい？
talk: ブス	何を思ってそうなったん？
talk: ブロックされた	気にしないで
talk: ブロックされていた	ブロックしかえそう
talk: プレゼントをもらった	最高の友達だね
talk: ヘアアイロン持ってき忘れた	イメチェンできるね
talk: ペット[が|]死んじゃった	いつも心の中にいるよ
talk: ペット[が|]死んだ	悲しいね、、、
talk: ペン忘れた	スマホかパソコンでメモしよう
talk: ホンの充電[が|]ない	イヤホン買っちゃお
talk: ボールペンを忘れた	貸すよ
talk: ポーズ[が|]寒い	どんなポーズ？？
talk: マイペース	のんきなのは心の余裕があるからよ
talk: マウントとられた	かわいそうな人なんだよ
talk: マウント取ってくる	取り返してやれ
talk: マスク[が|]嫌だ	マスクはコロナにとても効果があるんだよ
talk: マスクイケメンだった	それはマジで萎える
talk: ミニストップの新商品[が|]まずい	最近迷走してるよね
talk: ミュートし忘れた	ドンマイ
talk: ミュートし忘れて悪口言っちゃった	一旦何もなかったかのように退出しよう
talk: ミートソースをこぼした	うわああああああ！
talk: ムカつく	多めにみてやれー。悪気はないさ。
talk: メイク[が|]うまくいった	超かわいい
talk: メイク[が|]上手にできない	youtubeで勉強しよう
talk: メール違う人に送っちゃった	その人と話す機会ができたね！
talk: モテ期で辛い	いやいやいや・・・！
talk: モヤモヤする	大声で歌ってストレス発散だ！
talk: ヤバい	大丈夫だから冷静にな。
talk: ライバルに負けるかも	負けないようなことしよう
talk: ライブが中止になった	今度できるといいね
talk: ライブに落ちた	次は絶対に当選するよ
talk: ライブに落選した	ドンマイ次あるよ！
talk: ライブのチケット抽選申し込み忘れた	きっと当日券があるよ
talk: ライブの抽選落ちた	それは悲しい
talk: ライブ外れた	次当たるよ！
talk: リアルタイムで知れる	それも確かに
talk: リップ塗っても乾燥する	本当にそれな
talk: リモコン[が|]ない	探そう
talk: レポート出し忘れた	次がんばろ
talk: レンジ[が|]なくて困った	大切な物だから是非買って欲しいな～
talk: ログインし忘れた	忘れちゃうこともあるよね
talk: ワクチンの副作用	次の日には治るよ
talk: ワクチンの副反応[が|]辛い	すぐ治るから頑張って
talk: ワクチン怖い	いや？意外とそんなことないよ
talk: 一人	え、一人楽しくない？自由やで！
talk: 一生彼氏[が|]できない	そんな訳ない
talk: 上下関係[が|]分からない	敬語使っておけばとりあえずはオッケー
talk: 上司に八つ当たりされた	そんなに深刻に受け止めずに流して聞けばOK
talk: 下着一泊分忘れた	新しいものを買ういい機会だ
talk: 不安がある…	大丈夫よ
talk: 不審者に遭遇した	大丈夫だった？
talk: 卒業ラッシュ[が|]すごい	みんなずっといて
talk: 乗っ取られた	運営に言おう
talk: 乗り物酔いをした	薬を飲んでゆっくり休んでね！
talk: 乗る電車間違えた	間に合えば大丈夫！
talk: 乾燥[が|]ひどい	わかる、保湿しよ
talk: 乾燥して手が痛い	ハンドクリーム塗らないとね
talk: 予定[が|]ダブった	あとの予定はごめんなさい
talk: 予定[が|]入り過ぎている	一回整理してみたら
talk: 予定[が|]埋まらない	私と遊ぼう
talk: 予定すっぽかした	後で謝ろう
talk: 予定をドタキャンされた	今度全額奢ってもらおう
talk: 予約し忘れた	アポなしでも行けるっしょ？
talk: 予約忘れてた	今からでも間に合うかもしれないよ
talk: 予防接種痛い	仕方ない
talk: 事故った	逃げる方がヤバいからね？受け入れて反省しよ。
talk: 事故にあった	命があってよかったね
talk: 事故に遭った	大変！
talk: 二日酔い[が|]辛い	たくさん飲んだんだね、、
talk: 人とぶつかった	運命の相手かも⁉️
talk: 人に話しかけられない	難しいよね
talk: 人の名前を忘れた	仕方ない
talk: 人の名前を間違えた	会話が弾むいい機会だ
talk: 人の名前呼び間違えた	次から気を付けよう
talk: 人の投稿[が|]羨ましい	人は人自分は自分
talk: 人の気持ちを読み取れない	難しいよね
talk: 人を信用できない	自分を信用しよう
talk: 人前でうまく話せない	予行練習して話す前に深呼吸しよう
talk: 人前で転んだ	皆数日後には忘れるから大丈夫
talk: 人前に立つ仕事[が|]ある	頑張って
talk: 人多すぎ	コロナ怖いね
talk: 人生	人生辛いこともあるけどその分楽しいこともあるよな？
talk: 人目線	他人を気にして行動する人生でいいんすか？
talk: 人見知りで初対面の人と打ち解けられない	徐々に仲良くなれれば大丈夫だよ!
talk: 今日の夕飯何つくろうかな	自炊してるのえらい！
talk: 今日の振り返り	自分が気にしてても相手は気にしてないよ
talk: 今日の服可愛くない	いつも通り可愛いよ
talk: 今日は1日忙しかった	お疲れ様！ゆっくり休んでね
talk: 今日はよくミスをする	そんな日もあるよ!
talk: 今日もつかれた	お疲れ様！
talk: 今日も寝る時間[が|]遅くなった	毎日努力してて偉いね
talk: 今日提出の物があった	今から急いでやろう！
talk: 今日誕生日なのに誰にも祝ってもらえなかった	誕生日おめでとう！！
talk: 今日雨降るかなあ？	一応傘持ってた方がいいんじゃない？
talk: 仕事でミスをした	次気をつけよう
talk: 仕事で失敗した	失敗を生かそう
talk: 仕事のできない上司に呆れる	それは呆れてもしょうがない
talk: 仕事覚えられるかな	いけるっしょ！
talk: 他人と比べる	他人は他人、自分は自分。自分流に生きれる奴は（E）
talk: 他人と気[が|]合わない	それも個性さ
talk: 他人の傷つくことを簡単に言う人がいる	ひどいね
talk: 他大学の人たちと予定[が|]合わない	みんな忙しいから仕方ないよね…
talk: 仮眠しようとしたら4時間寝てた	次の日頑張れば大丈夫
talk: 仲良い友達が遠くに引っ越した	私が仲良い友達だよ！
talk: 企業に電話する	経験値上がるね
talk: 伝言を伝え忘れた	伝えに行かなきゃ
talk: 低気圧のせいで頭[が|]痛い	今日はゆっくりしよう
talk: 体[が|]痛い	整体行こう
talk: 体調[が|]よくない	しっかり寝よう
talk: 体調管理を失敗した	体調は天気や状況でも変わるから仕方がない
talk: 何もできない自分がみじめ	そんなことない
talk: 何もできない自分にイライラする	そんなことない！
talk: 何もないところで[転んだ|こけた]	大丈夫？
talk: 何も言い返せなかった	優しいね
talk: 何をするのか忘れた	よくあることだね
talk: 依存から離れられない	それな！
talk: 保存されてなかった	次やるときはバックアップとっておこう
talk: 保存し忘れていた	タイピング力上がるね
talk: 個人情報[が|]バレた	やばいな
talk: 偏頭痛[が|]する	無理しないでね
talk: 傘を忘れちゃった	止まないかなぁ
talk: 傘を忘れて雨になった	隣にいる人の傘に入ってしまおう
talk: 傘忘れた	その分荷物軽いね
talk: 働きたくない	それな！
talk: 優しくなりたい	そう思ってるだけで優しいよ
talk: 優柔不断	決めるの難しいよね
talk: 元カノと比較された	自分にしかない個性を示そう
talk: 元カレとあった	フッタことを後悔させてやれ
talk: 充電し忘れた	短期集中できるね
talk: 充電コードを忘れた	貸すよ
talk: 充電切れた	充電器貸してあげる
talk: 先生に怒られた	あなたが悪いとは限らない！
talk: 先生の声[が|]小さくて聞こえない	この授業捨てようよ
talk: 先生をお母さんって呼んじゃった	小学生みたいだね
talk: 先生来ない	予習できるね
talk: 先輩に対し「OK」と返事してしまった	それだけ疲れていたんだよ仲がいいって
talk: 入会費[が|]高い	その分いい経験ができることに期待しよう
talk: 入院した	容体は？
talk: 全然わからない	私も分からない！おそろいだね！
talk: 八つ当たりされた	聞き流そう
talk: 内定もらえない	そんじゃ、私と開業しない？（笑）
talk: 写真を撮るの難しい	たくさん撮ろう
talk: 写真写り[が|]悪い	わかる!、ちょっと後ろに立って写ってみたら？
talk: 写真写り悪くて載せれる写真ない	風景とか載せとけ
talk: 冬の海に飛び込んでいて寒そう	リアクション芸人か！
talk: 冬服[が|]ない	買い物に行こう
talk: 冷え性だ	暖かい恰好で過ごそう
talk: 冷めやすいんだよね	いろんな事を体験できるじゃん
talk: 冷蔵庫のプリン食べられた	また買ってこよう
talk: 出席忘れた	まだ落単じゃないよ！
talk: 切符を無くしちゃった	駅員さんに言えば大丈夫だよ
talk: 初めての場所に一人でいる	あなたなら大丈夫！
talk: 初めて高速道路で運転する	安全運転！
talk: 初対面の人から遊びに誘われた	見極めてね
talk: 別れたい	よーく考えてから決めればええ。
talk: 制限きた通信制限ー	Wi-Fi活用！
talk: 前の席の子に話しかけていいのか	話しかけよ！
talk: 前後逆に服着てた	案外まわりは気づいてないかも？
talk: 前髪を切りすぎた	え、まじでにあってるよ！？
talk: 勉強	今が頑張りどきやで！頑張れば結果がついてくる。
talk: 勉強[が|]うまくいかない	誰かと一緒にやろう
talk: 勉強したくない	頑張ったら良いことあるんじゃない？
talk: 勉強するときにペンを忘れた	隣に座っている人に借りよう
talk: 勉強にがて	自分が手を出せそうに思ったところからとりあえずやってみよう
talk: 勉強のやる気が起きない	そんなときもあるよね
talk: 勝手に写真[が|]使われた	あなたの写真が素晴らしいからだよ
talk: 包丁で切ってしまった	痛いねぇ
talk: 半袖は寒すぎた	早くカフェ行こ
talk: 卒業しちゃった	何事も終わりはあるんやで？さあ、新しい領域へ！HaHa
talk: 卒業ラッシュで悲しい	本人が決めたことを尊重しよう。
talk: 単位とれなかった	来年頑張ろう
talk: 単位取れるか不安	一緒に勉強しよう
talk: 単位来ないかも	一個くらい大丈夫
talk: 単位落とした	もう落としたものは仕方ない
talk: 占い結果[が|]悪かった	占いは非科学的なものが多いから、気にしなくて大丈夫！
talk: 卵[が|]一つもない	買いに行こう
talk: 卵割れた	今日は卵焼きにしよう
talk: 友達[が|]いない	私がいるよ
talk: 友達[が|]冷たい	それはつらいね
talk: 友達が同じことを[何度も|]聞いてくる	しつこいのは嫌だなぁ
talk: 友達[が|]増えた	私にも紹介して！
talk: 友達[が|]増えない	きっとこれからできるよ
talk: 友達[が|]引っ越した	定期的に電話したら良いよ
talk: 友達[が|][待ち合わせに|]遅れた	遅れてくるのは良くないよね
talk: 友達[が|][待ち合わせ時間に|]来ない	きっと来るよ!
talk: 友達が[数日|][学校を|]休んでいる	心配だね
talk: 友達できるかな	作るんよ！
talk: [友達との|]待ち合わせに遅刻した	すぐ謝ろう!
talk: 友達とはぐれた	探せ探せ
talk: 友達と予定が合わない	その子に嫌われているのかも
talk: 友達と喧嘩した	仲直りできるといいね
talk: 友達と喧嘩しちゃった	仲直りは早い方がいいよ
talk: 友達と少し言い争ってもやもやする	納得いくまで話し合ったらいいよ
talk: 友達と服かぶった	流行りなんだよ
talk: 友達と間違えて知らない人に声かけちゃった	向こうも多分察してくれてるだろうから大丈夫だよ
talk: 友達にどう思われてるかな	悪く思われてないよ！大丈夫！
talk: 友達にひどいことを言ってしまった	素直に謝ってみよう
talk: 友達に会えなかった	明日はきっと会える！
talk: 友達に似てたから話しかけたら全く知らない人だった	そのひととも友達になろう
talk: 友達に否定された	気にすることじゃない
talk: 友達に悪口言われた	気にすることじゃない
talk: 友達に気の利いた声をかけてあげられない	あなたは十分できてるよ
talk: 友達に騙された	もう騙されないぞ！
talk: 友達の傷つくことを言ってしまった	謝ってみよう
talk: 友達の名前を言い間違えた	間違えた！って言ってみよう
talk: 友達の名前を間違えて呼んだ	そういうときもあるよね
talk: 友達の推しが卒業した	出来ることからしてあげよ
talk: 友達の機嫌[が|]悪い	気を付けて行動しよう
talk: 友達の状況を知れる	確かに！
talk: 友達怒ってないかな	思い違いってことよくあるよ
talk: 友達欲しい	もう友達じゃん
talk: 反応[が|]来ない	いつか来るよ
talk: 反応を気にしてしまう	あんまり気にしない方がいいかも
talk: 収入源[が|]途絶えた	またすぐ見つかるよ
talk: 取っておいたプリンを食べられた	請求しよう！
talk: 取り敢えず悲しい	気分をあげに行こう！
talk: 受験票を忘れた	それは悲しい
talk: 受験落ちた	頑張ってよかったと思える日が必ずくるよ
talk: 口内炎[が|]できた	ビタミン摂って！
talk: 口内炎[が|]痛い	ビタミン摂って！
talk: 口内炎だ	ビタミン摂って！
talk: 叩かれた	暴力反対！
talk: 可愛くなりたい	出来ることから始めよう
talk: 吊り革触りたくない	椅子確保！
talk: 同期と仲良くなれるかな	飲みニケーション！
talk: 告白したい	当たって砕けな！
talk: 告白するか迷う	悔いのないように！
talk: 告白するタイミングを逃した	まだタイミングはこれから来るはず！
talk: 周り[が|の]就活進んでて焦る	それな
talk: 周りとなじめない	何色にも染まらないなんて素敵
talk: 周りの目が怖い	わかる
talk: 周りの音がうるさい	イヤホンで好きな音楽を聴いてみよう
talk: 味付け微妙	失敗は成功のもと！
talk: 味方[が|]いない	そんなことない
talk: 唐辛子[が|]辛すぎる	チーズ入れるといいよ
talk: 商品[が|]破損していた	嫌だね
talk: 喉[が|]痛い	のど飴食べる？
talk: 喧嘩した	時間が経てば元に戻れる
talk: 嘘をついてしまった	正直に言ってみよう
talk: 困った	問題解決は原因を分析することが一番やで！よく考えて次に行動しよう。
talk: 変なお客さん来ないといいな	来ませんように
talk: 変なことをつぶやいてしまったかもしれない	いうほど一つの言葉を気にする人は多くない
talk: 変な人に絡まれた	逃げた方がいいね
talk: 変換[が|]上手くいかない	注意力上がるね
talk: 夏休み終わった	もうすぐ冬休みくるよ
talk: 外[が|]寒い	冬〜って感じ
talk: 外出禁止になった	ステイホームを楽しもう
talk: 外国語で道を聞かれた	ジェスチャーで何とかしてみよう
talk: 外食したら行列が…	きっと美味しいんだ！
talk: [外食した後に|]財布がないことに気付いた	皿洗いをして帰りましょう
talk: 多くの仕事を任された	信頼されてるんだね
talk: 夜[に|][寝|眠]れない	朝早く起きよう！
talk: 夜更かししちゃう	昼夜逆転わかる
talk: 夜更かししてしまう	同じく
talk: 夜道[が|]暗い	気をつけて！
talk: 大きいクモに遭遇した	クモは益虫だから、出ても気にしなくてOK
talk: 大事なものをなくした	探し物は探すのをやめたときにみつかるよ
talk: 大事な日に寝坊した	次にこの失敗を繰り返さないように気をつけよう
talk: 大事な書類が破れた	どうしよう
talk: 大切にしていたものを間違えて捨ててしまった	次から、落とさないような場所に置けばOK
talk: 大勢の人の前で転んだ	大丈夫！？記憶は薄れるだろうし気にしない気にしない！
talk: 大声出してめっちゃ見られた	私もたまにやる、気を付けよう…
talk: 天気[が|]悪くて洗濯物[が|]たまる	コインランドリーいいよ
talk: 太った	食べる量減らしてみたら？
talk: 失敗した	過去から学び、今日のために生き、未来に希望をもとう。
talk: 失敗したらどうしよう	それも経験！
talk: 好きだったドラマ[が|]終わってしまう	来クールにもっとハマれるドラマがあるかもよ?
talk: 好きなことだけしていたい	もうひと踏ん張り！
talk: 好きなアイドルと会えた	一生の思い出じゃん
talk: 好きなユーチューバー[が|]配信やめた	他のユーチューバー探そう
talk: 好きな人から返信来ない	たまたまだよ
talk: 好きな人[が|]ナルシストだった	それは萎えるね
talk: 好きな人と喧嘩した	喧嘩するほど仲がいいよ
talk: 好きな人に[彼氏|[恋人|好きな人]][が|]できた	あの人イマイチだったよ！他にいい人いるよ！
talk: 好きな人今誰といるのかな	きっと家で寝てるよ
talk: 好きな人彼女いるかな	大丈夫君が彼女だよ
talk: 好きな俳優[が|]問題を起こした	わかる、、
talk: 好きな俳優[が|]引退した	新しいすきを見つけに行こう
talk: 好きな女優[が|]結婚した	でも幸せならオッケーです
talk: 嫌いなシフト被った	コミュ力上げるチャンス！
talk: 嫌いな人に会った	人生の主役はあなた！気にしなくて良いよ
talk: 嫌いな食べ物[が|]出てきた	あとで、美味しいもの食べれると思って頑張って!
talk: 嫌なことされただけど許した	愛が無きゃ許せないよ
talk: 嬉しいことをされた	ほんとに愛してるわ
talk: 子供[が|]挨拶してきて困ってしまった	返してあげれば喜んでもらえるかも
talk: 存在[が|]薄くて悲しい	私にとってはあなたの存在は十分濃いよ。
talk: 学校が休みになった	遊んじゃおう
talk: 完結した	２週目見るか
talk: 定期なくした	もっとよく探そう
talk: 定期忘れた	ドンマイ
talk: 実験レポートを忘れた	そんな時もあるよ
talk: 実験実習費の納入[が|]間に合わなかった	締め切り過ぎてても大丈夫だよ
talk: 宣告された	余命宣告されてない人だっていつ死ぬかわからんから悔いのないように生きよ！
talk: 家から出たくない	遊びに行っていい？
talk: 家にスマホ忘れた	なくてもなんとかなる
talk: 家に強盗犯[が|]入ってくるかもしれない	宝くじに当たるくらいの確率だから、多分入ってこないと思うよ!
talk: 家の鍵をなくした	あれま
talk: 家の鍵忘れた	よくあるね
talk: 家の鍵忘れちゃった	誰か帰ってくるまで時間潰しに行こ
talk: 家の鍵閉め忘れたかも	確認しに帰った方がいいよ！
talk: 家を出たら財布を忘れた	今日は一日ヒモになろう
talk: 家事得意	いい奥さんになれるね
talk: 家計簿の計算[が|]合わない	おかしいな
talk: 家電[が|]壊れた	買い替え時だったんだよきっと…
talk: 宿題[が|]終わらない	できるところまでやろう
talk: 宿題家だ…	ドンマイ
talk: 宿題忘れた	たまには休憩も必要だよ
talk: 寒い	風邪ひかないように温かくしてね
talk: 寒いから布団から出たくない	あるあるだね
talk: 寝ぐせついたままだった	なおせそう？
talk: 寝ているとき以外眠い	生活リズムを整えよう
talk: 寝ながらスマホ見てたら顔の上に落ちてきた	一旦病院に行ってみよう
talk: 寝なきゃいけないのに寝れない	ホットミルク飲むと良いよー
talk: 寝れない	アロマとか音楽とかどうかな？？
talk: 寝不足だ	眠いよね
talk: 寝不足だけど出かけなきゃ	無理しないで
talk: 寝坊した	急げ！！
talk: 寝坊して選考受けられなかった	この会社には縁がなかったと思おう
talk: 寝癖すごい	可愛いよ♡
talk: 寝言言っちゃった	あらら、ちなみに何て言ってたの？
talk: 寝過ごした	それだけ疲れていたんだよ
talk: 寝過ごした	私も１時間くらい寝過ごしたことあるから大丈夫！
talk: 寝違えちゃった	痛いよね、まずは安静にして様子をみよう
talk: [寺田蘭世さんが|]芸能界から引退しちゃう	悪いニュースだね
talk: 対応[が|の]悪い店員がいた	別のお店に行こう
talk: 専攻はずれた	こっちから願い下げじゃない？
talk: 将来がみえない	まだいろんな道を選べるよ
talk: 将来が不安	私も不安すぎる
talk: 将来どうなるだろう	やりたいこと見つけよう
talk: 将来の夢がない	選択肢増やすために勉強しよう
talk: 将来生きていけるかな	なんとかなる！
talk: 小指ぶつけた	痛いの痛いの飛んでいけ〜
talk: 就活したくない	それな！！！
talk: 就活しなきゃ	ゆっくりやっていこう
talk: 就活どうしよう	先輩や先生に相談しよう
talk: 就活に落ちた	きっと他の良い会社に行けるよ!
talk: 就活やる気でない	仲間みつけよう
talk: 就職できるかな	なんとかなる！
talk: 就職どうしよう	たくさん調べよう
talk: 就職先決まるかな？	大丈夫！心配しなくて大丈夫だよ！
talk: 就職出来るかな	自分を理解して突き進むしかない
talk: 尻餅をついた	大丈夫？
talk: 左右違う靴下はいてきちゃった	やっちゃったね…
talk: 常に眠い	寝な
talk: 年末年始にやることが多い	わかる。
talk: 床に落ちてた犬のフンを踏んでしまった	運が付いたと思おう
talk: 店員さんとお客さんを間違えた	紛らわしいときあるよね、次から気を付けよ…
talk: 弟が反抗期	そのうち終わるよ
talk: 弟が学校に行かなくなっちゃった	お布団巻き巻きで歩いてみよ
talk: 弟に身長を抜かれた	しょうがない
talk: [彼氏|彼女]の名前を呼び間違えた	やらかしたな
talk: 彼氏[が|]できた	惚気る気？
talk: 彼氏[が|]できない！	焦らずいこ～
talk: 彼氏が元カノと仲良い	可愛く拗ねよう！
talk: 彼氏と別れた	次の出会いがあるよ
talk: 彼氏に振られた	もっといい人いるよ
talk: 彼氏の返信[が|]遅い	いそがしいんだよ、きっと
talk: 彼氏をとられた	許せないね
talk: 待ち合わせの時間間違えた	次は気を付けよう
talk: 待ち合わせ時間間違えてた	次は気を付けよう
talk: 必要とされていない	そんなことはないさ！
talk: 志望動機が特にない	わかる
talk: 忘れた	何を忘れたんだい？人間忘れる生き物さ。
talk: 忘れ物をした	取りに帰る？
talk: 応募期間過ぎてた	次の機会にかけよう
talk: 怒ってる人と同じ空間にいるとき	私だったら怖くて逃げちゃう
talk: 怒られた	次に活かそう
talk: 怖い	怖くないよ
talk: 怖い夢[|を]見た	夢でよかったね
talk: 思うようにいかない	人生甘くないんやで！
talk: 思ったことを気軽につぶやけないときがある	その方がいいよ！口は災い元だから！
talk: 急に全てがめんどくさくなる[|ときがある]	誰にでもある
talk: 急に雨が降ってきた	雨宿りしよう
talk: 性格悪い人が苦手	得意な人はいない
talk: 怪我した	お大事に。
talk: 怪我で試合に出られない	それは悔しいね
talk: [彼氏|[恋人|好きな人]]が何を考えているかわからない	多分悪いことは考えてないよ
talk: [彼氏|[恋人|好きな人]]に冷めた	何かあったんだね、
talk: [彼氏|[恋人|好きな人]]に振られた	新しい出会いあるよ！
talk: 恥ずかしいところを見られた	その人の記憶なくなれば良いのにね
talk: 悩みがない	幸せだなぁ
talk: 悩みがないことが悩み	幸せだなぁ
talk: 悪いこと[|が起きること]を恐れる	気にしすぎ！
talk: 悪口[|を]言われてるかも	思ってる以上にみんな人のこと見てないよ
talk: 悪夢[|を]見た	今日はいい夢見れるよ！
talk: 悪寒がする	あったかくして寝よう
talk: 悲しい	悲しいね！
talk: 情報取集[|を]たくさんできる	それはいいこと！
talk: 憧れの人と話すとき	憧れの人と話せるなんていいね
talk: 成功するかな	この世に男はたくさんいる
talk: 手が乾燥してきた…	良い香りのハンドクリームを使ってみよう！
talk: [手越くん|]卒業しちゃった	しちゃったね
talk: 承認してくれなかった	間違えて削除しちゃったんだよ
talk: [投稿したら|]いいね数が少なかった	そうゆう時もある！
talk: [投稿で|]マウントをとられる	気にしちゃだめ
talk: 抽選に落ちた	運が溜まっていると思って元気出して!
talk: 抽選[が|]外れた	次は当たるよ
talk: 指名される	記憶に残っていいね
talk: 指[|を]挟んだ	痛いね
talk: 挫折した	人生諦めも重要。
talk: 振られた	その人見る目ないね
talk: 振り込み[|を]忘れてた	まだ間に合うよ
talk: 捻挫した	ちゃんとストレッチ？
talk: 授業[|が]長かった	お疲れ様！
talk: 授業ノートをなくして勉強ができない	私のでよければ貸すからそんなに落ち込まないで!
talk: 授業休講のこと知らずに学校来ちゃった	良い運動だ！
talk: 推しがSNSで叩かれた	推しが素敵だから嫉妬してるんだよ
talk: 推しがあんまり更新してくれない	忙しかったり体調悪いのかもね
talk: 推しがエラーした	そういうときもあるさ
talk: 推しがクビになった	推しのセカンドキャリアも応援しよう
talk: 推しが卒業…	それは無理
talk: 推しが卒業だって	それは無理
talk: 推しが尊すぎる	それなー
talk: 推しが引退した	それは無理
talk: 推しが打たれた	そういうときもあるさ
talk: 推しが炎上した	あー、それはドンマイ
talk: 推しのイベントが多[い|くて楽しくて仕方ない]	幸せ者やねっ！
talk: 推しの[キャラクター|]グッズをたくさん買ってしまう	わかる！
talk: 推しの投稿が減った	いそがしいんだよ、きっと
talk: 推しの投稿頻度が少ない	今忙しいんだよ！きっと
talk: 推しが最下位になった	次は大丈夫だよ
talk: 推し被りが匂わせしてる	満たされてないんだよ
talk: 提出し忘れた	今月はゆっくりできるね
talk: 提出の課題持ってくるの忘れた	次回忘れないようにしよう
talk: 提出ミスをした	次は間違えないね
talk: 提出出来なかった	それは、ちゃんと確認しよ
talk: 提出忘れた	遅れてもいいから提出しよう
talk: 提出期限間に合わなかった	4回まではセーフ
talk: 提出物だし忘れた	提出物忘れ一回？余裕だね！
talk: 改札でお金がないことに気づいた	ドンマイ
talk: 改札[|に]引っかかった	ウケる
talk: 教科書[|を]忘れた	友達に見せてもらおう！
talk: 整形したい	そのままでも十分かわいいけれど、自分がしたいならすればいいさ
talk: [料理してたら|]指切った	絆創膏あげようか？
talk: 料理を作りすぎた	たくさん食べられるね＾＾
talk: 断れない	嫌ならはっきり断りな！
talk: 新しい服[|を]買った	似合ってるよ
talk: 新入生の名前と顔が一致しない	覚えようとしていることがすごい
talk: 新学期[が|]始まる	楽しんでいこう
talk: 新発売のお菓子がコンビニ限定…	高いよね…
talk: 旅行の日にちを間違えた	急いで準備しよう
talk: 既読[|を]無視された	いそがしいんだよ、きっと
talk: 日焼けした	それは痛い
talk: 早く帰りたい	残ることでできる人間関係もある！お疲れ様
talk: 早起きできない	電話かけようか？
talk: 明日その服着よう	どんな服でも似合うよ
talk: 明日の着替えがない	急いで選択しよう
talk: 明日の試合[|は|に]勝てるかな	応援してるよ
talk: 明日[|は][|バイト]初日だ	挨拶しっかりね！
talk: 明日[|は]ゼミの発表だ	大丈夫だよ
talk: 明日[|は]テストだ	最後まで足掻こう
talk: [明日提出の|]課題が終わらない	焦らず着実に進めてこ
talk: 明日発表	発表前に深呼吸してね
talk: 明日[|は]起きれるかな	早く寝よう
talk: 明日[|は]起きれるか不安	早く寝よう
talk: 明日[|は]面接だ	頑張れ
talk: 映えない	映えてる
talk: 時間の使い方が下手	難しいよね
talk: 普通の子	そこはかとなくいい感じだよね！
talk: 暑い	アイスが美味しい季節！
talk: [[暖かい|冷たい]飲み物が|]売り切れ	地味に辛い
talk: 暖房[|が]暑すぎた	温度を下げよう
talk: 暗い道[|が]怖い	気をつけてね
talk: 更新[|が]めんどい	しなくても良いのよ
talk: 最悪	ネガティヴは損だよ
talk: [[最近の|]事件のせいで|]外に出るのが怖い	そうだよね怖いよね
talk: [最近|]休みが無くて疲れた	大変そうだね、、
talk: [最近|]寝ても寝ても眠い	寝れるだけ寝るんだ！
talk: [最近|]彼氏が冷たい	それはつらいね
talk: [最近|]忙しい	忙しいっていうのは悪いことではないよ!
talk: [最近|]物騒で電車に乗りたくない	だね、スマホに見入ったり、寝たりしないようにしてい気をつけよう！
talk: 服[|が]決まらない	なんでも似合うよ
talk: 服[|が]ない	一緒に買いにいこ〜
talk: 服に染み付いた	クリーニングだわ
talk: 服に虫[|が]ついた	きっしょ
talk: 服のタグが付きっぱなしだった	それめっちゃ恥ずかしいね、どんまい
talk: 服の色が寒そう	寒色も良いぞ。
talk: 服汚した	洗ってきな
talk: 服[|が]逆だった	まじか、気づかなかった
talk: [朝たまたま見た|]占い[の結果|]が悪かった	気にしなくて大丈夫！
talk: 朝[|が|に]起きれない	アラームガンガンにしてみよう
talk: 本の置き場[|が]なくなってきた	電子書籍増やしてみる？
talk: 本を読むのに飽きた	新しいこと始めよう
talk: 来た道[|が|を]覚えられない	感覚に頼らずにマップ見て帰ろう
talk: [来週|]模擬授業だ	頑張れ
talk: [来週|]面接だ	頑張って！応援してるよ
talk: 株で大損した	次は逆にいいことあるかもよ
talk: 椅子の高さが合わない	こっちと交換すれば？
talk: 楽しい	よかった！
talk: 楽しそうな投稿がうらやましい	こっちも楽しもう！
talk: 次回が気になる	次までワクワク期間だ！
talk: 欲しいものが売り切れだった	また明日行ってみよう！
talk: 欲しいものを買えなかった	他の店に買いに行こう！
talk: 欲しかったものがお店に行ったら売り切れていた	きっとそれよりいいものが買えるよ!
talk: 欲しかったものが売り切れた	きっと再販するよ
talk: 欲しかったグッズ売り切れてた	残念だね、、再販待とう
talk: 歯が痛い	歯医者行こう
talk: 歯ブラシ買い忘れた	違う種類の試すいい機会だ
talk: 死にたい…	あなたが死んだら悲しい！
talk: 死んだ	君はまだ生きている！残された人生楽しもう。
talk: 毎日やることがたくさんある	毎日頑張ってるの知ってるよ
talk: 気持ち悪いコメントしてくる人がいる	きもいね無視しよう
talk: 気軽に相談できる相手がいない環境にいる	私も春はそういう環境になることもあったけれども、そういう時は自分から積極的に話しかけてみたら仲いい人も見つかったよ!
talk: 水をこぼした	手滑っちゃうよね
talk: 水溜りに入った	水の滴るいい女になったね
talk: 水着着て行って下着忘れた	やっちゃったね…
talk: 水筒こぼした	早く拭こう
talk: 泣きたい	存分に泣けばいい。
talk: 泥棒が来るかもしれない	ちゃんと鍵を閉めていれば入ってこないよ!
talk: 注文を言い間違えた	言い直せば大丈夫！
talk: 洗濯してしまった	後始末が大変だ
talk: 洗濯物[を|][しまい|取り込み]忘れた	雨振らないように
talk: [洗濯[|を]物干した瞬間|]雨が降ってきた	タイミング悪しだね
talk: 派手に転んだ	大丈夫？
talk: 浮気された	し返せ
talk: 浮気されてるかも	知らない方がいいこともある
talk: 海外に[行きたい|行けない]	いつかは行けるようになるよ
talk: 混雑に巻き込まれた	時間をずらそう
talk: 渋滞[…|で進めない]	みんなでゲームでもしよ！
talk: 渋滞に引っかかった	みんなでゲームでもしよ！
talk: 満員電車[…|が辛い]	嫌だよね
talk: 満員電車で乗れない	頑張って！
talk: 満員電車で痴漢された	それ通報した方がいいよ
talk: 満員電車に乗ってしまった	嫌だよね
talk: 準備大変	大変な思いはいつか報われるよ
talk: 滑ったコメントをしてしまった	ネットの海に消えるのみ
talk: 滑って転んだ	トークではもうすべらないかも
talk: 漢字の変換を間違えた	直せばいいだけ！
talk: 火を消し忘れたかも…	いったん戻るしかないかも
talk: 火傷した	痕残らないといいね
talk: 火力をミスって焦がした	火が通ってなくておなかを壊すよりいいと思おう
talk: 炊飯器のスイッチ入れてなかった	ご飯はもうちょっと待とう
talk: 炎上した	そうゆう時もある
talk: 炎上してる	あれま
talk: 炭酸が爆発した	強い炭酸ってことが分かったね
talk: 無理[|だ]	まあまあ
talk: 無視された	気づいてないだけだよ
talk: 熱が出た	温かくして寝てね
talk: 熱心に教えてたらウザがられた	情に熱い良い人だと思うよ
talk: 爆音宣伝トラックが通りかかった	イヤフォンで遮断しましょう
talk: 牛乳[|を]買い忘れた	ミルクティーが飲めない
talk: 物忘れがひどい	たくさんのことをかんがえてるんだね
talk: 物欲[が|][ひどい|とまらない]	お財布と相談やな！
talk: 物覚えが悪い	なんでも覚えるのは大変だよね
talk: 特定の人にだけ引用リツイートされる	ブロックしちゃえ
talk: 犬[が|]怖い	猫の方が怖いよ
talk: 犬[が|]脱走した	追いかけよう！！
talk: 犬に噛まれた	お大事に
talk: 犬の糞を踏んだ	どんな田舎？
talk: 犯人を逃した	早く見つけて捕まえよう！
talk: 独り暮らしを始めた	徐々に慣れていくよ
talk: 猫[が|][苦手|怖い]	ちょっと怖く見えるよね
talk: 猫にごはんあげるの忘れた	今すぐ帰ってあげな
talk: 猫に引っかかれた	友達の証
talk: 猫の手借りたい…	ฅ^• ·̫ •^ฅ 貸そうか？
talk: 献立[|を]思いつかない	検索すれば美味しいもの出てくるよ！
talk: 現金[|を]忘れた	キャッシュレス還元率高いよ
talk: 生きているのがつらい	一人じゃないよ
talk: 生理的に無理な人が増える	相手の良いところを探してみよう
talk: 甲子園を逃した	練習は無駄じゃないよ
talk: 目[|が]疲れた	一旦、休もっか
talk: 画面を見すぎて目[|が]疲れた	一旦、休もっか
talk: 画面オフだと思っていたらオンになっていた	一旦何もなかったかのように退出しよう
talk: 疲れた	お疲れ様^_^
talk: 疲れて心が痛い	まずは、遊ぼう！
talk: 痛い	痛いの痛いの飛んでけー！
talk: 痩せれない	それな
talk: 痴漢された	警察に突き出そう
talk: 発表[|を]うまくできるかな	不安ならとことん練習あるのみ！
talk: [白い[|服に]|]コーヒーこぼした	ショック！
talk: 目が痛い	一旦、休もっか
talk: 目が腫れた	安静にしよ
talk: 目にまつげが入った	鏡あるよ
talk: 目にゴミ入った	洗い流してー
talk: 目の前で[乗りたい|]電車のドアが閉まった	のんびり余裕をもって移動ができたね
talk: 目の前で品切れになった	別の店にはないかな？
talk: 相手が遅刻してきた	注意しよう
talk: 相手の名前を忘れてしまった	よくあるよね
talk: 相手を間違えてLINEしちゃった	いろんな意味で大丈夫だった？
talk: 相談聞いて	心得た！
talk: 眠い	お昼寝しとく？
talk: 眠いけど起きなきゃ	今日も一日頑張れ
talk: 眠れない	アイマスクをしよう
talk: 眼鏡[を|]なくした	もう一回落ち着いて探そう！
talk: 眼鏡[|が]似合わない	似合ってるよ
talk: 着ている服[が|]寒そう	暖かい服を着せよう
talk: 着る服[が|]ない	とりあえずあるもので考えよう！
talk: 知らない人からずっと[|メッセージがくる]	ブロックしよ
talk: 短気かも	すぐに熱くなれるんだね
talk: 砂糖と塩を間違えた	味が気になる…
talk: 社会で生きていけるかな	なるようになる！
talk: 社会人人生不安	Me,too
talk: 祝日なのに休みじゃなかった	残念！
talk: [[私服で|]会場に行ったら|]皆スーツだった	笑笑
talk: 空き巣に入られた	警察に届け出よう
talk: 第一志望に落ちた	他の大学でもきっといいことが待ってるはず
talk: 筆箱[|を]忘れた	ペン貸そうか？
talk: 筋トレ[が|]続かない	5分でいいから続けよ
talk: 筋肉痛[|だ]	ストレッチして、ゆっくり休んでね!
talk: 筋肉痛で足が痛い	ストレッチして、ゆっくり休んでね!
talk: 粒餡派が少数で辛い	私、粒あん派♥
talk: 約束を忘れ[|て]た	素直に謝ろう
talk: 紅白に落選した	レコ大には当選した？
talk: 納期を間違えた	何の仕事中？
talk: 紙で切ってしまった	地味に痛い
talk: 紙で指を切った	地味に痛い
talk: 紙で指を切ってしまった	地味に痛い
talk: 紙を破った	またコピーすればいいさ
talk: 終わった	課題ならよかったね
talk: 終電[|を]逃した	サイゼ行こうか
talk: 結婚[できる|出来る]かな	きっとできるよ
talk: 結婚相手がいない	探す手段はたくさんあるので試しましょう
talk: 給食の揚げパン落とした	ドンマイ（ ; ; ）
talk: 綺麗な景色が一瞬で消えてしまう	一瞬だからこそ良いよね
talk: 緊張しい	落ち着いて！
talk: 緊張する[|とお腹が痛くなる]	ツボを押してみよう
talk: 縁石につまずいた	いたたた
talk: 美容室の予約時間[|が]過ぎてた	連絡すれば大丈夫
talk: 美容院お金かかりすぎ…	美容師の友達探す
talk: 耳[が|]痛い	イヤホンのしすぎかも？
talk: 肌が乾燥するの	保湿大事
talk: 肌荒れがひどい	野菜沢山食べていっぱい寝よう
talk: 肌荒れしちゃった	栄養しっかり摂って寝よう
talk: 肘をぶつけた	肘ぶつけるとジンジンするよね
talk: 肩[|が]凝った	お疲れ様
talk: 肩[|が]痛い	サロンパス貼ると、すぐに治るよ!
talk: 肩こり[|が]ひどい	大丈夫？ゆっくり休んで
talk: 腰[|が]痛い	大丈夫？重いものとか持たないようにね！
talk: 腹痛	さっさとEVE飲もう！
talk: 膝[|が]痛い	無理しないで〜
talk: 自分がこのグループにいていいのかわからない	いていいんだよ！
talk: 自分が不愛想だと思う	不愛想じゃないよ
talk: 自分だけ可愛くない	そんなことないよー！
talk: 自分に自信が持てない	下には下がいるよ！
talk: 自分のするべきことがわからない	出来ることから始めよう
talk: 自分のせいで試合に負けてしまったんじゃないか	そんなことないよ
talk: 自分の失敗を人に笑われた	笑った人は時間が経てば忘れると思うから、気にしないで!
talk: 自分の好みが変わった	そうゆう時もあるよね
talk: 自分より才能がある人に嫉妬する	少しずつ努力しよう
talk: 自転車がパンクした	徒歩帰宅？
talk: 自転車で転んだ	大きなけががなくてよかった
talk: 自転車とぶつかりそうになった	危ない！
talk: 自転車を倒した	直しとくよ
talk: 自転車盗まれた	最悪じゃん
talk: 舌[|を]嚙んだ	きいてるだけで痛い!!
talk: 良い言葉が出てこない	伝われば大丈夫だよ
talk: 花粉無理	それな
talk: 花粉症がひどい	薬飲んだ？
talk: 苦いカクテルを頼んでしまった	鼻つまんで飲むといいよ
talk: 英語が出来る	石油王と結婚出来るんじゃない？
talk: 英語の先生めっちゃ当ててきた	why？
talk: 荷物[が|]重い	カート使おう
talk: 荷物[が|]重すぎて運べない	カート使おう
talk: 落ちた	何に？？
talk: 落選した	オンラインでみよう！
talk: 薬[を|]飲み忘れた	すぐ飲もう
talk: 虫歯[が|]できた	いよいよ歯医者に行く時だ
talk: 虫歯[が|]痛い	いよいよ歯医者に行く時だ
talk: 虫歯になった	いよいよ歯医者に行く時だ
talk: 蚊に刺された	ムヒ！
talk: 蜂に追いかけられた	考えたくない
talk: 融通が利かない[|節があるの]	真面目に生きてるってことだからいいことじゃない？
talk: 行きたいところに就職できるかな	なんとかなるよ
talk: 裏アカがばれた	笑笑
talk: 裏垢とサブ垢間違えた	すぐに消そう
talk: 見たかったドラマを見逃した	見逃し配信あるよ
talk: 見ていて寒い	暖かそうな服をおすすめしよう。
talk: 見過ぎちゃう	他にやることあるでしょ
talk: 視力[が|]下がった	画面とか見る時間多いもんね
talk: 視力[が|]悪い	画面とか見る時間多いもんね
talk: 親が干渉してくる	自分の意見を言った方がいい
talk: 親と喧嘩した	似たもの同士
talk: 親にアカウントばれたかも	連絡先同期してるとあるよねー
talk: 親に怒られた	嫌だね
talk: 親に言われる	自分の人生なのに。
talk: 親友に仲の良い友達が出来た	気にしすぎちゃダメ
talk: 親戚が病気になった	きっと治るよ
talk: 親戚の人に久々に会うとき	久々に会う人はなんだか緊張するよね
talk: 親戚の話が長い	大変だよね〜
talk: 角に足の小指をぶつけた	角が君を愛しているそうだ。
talk: 言葉遣いが悪い	練習しよう
talk: 許しをこう	心の広さ太平洋かよ
talk: 許可なしで写真載せられた	個人情報はダメだよね
talk: 試合に負けた	よく頑張ったね、お疲れ様
talk: 試験が近い	自分を信じて
talk: 試験に落ちた	次頑張ればいいよ！
talk: 試験勉強を少ししかしなかった	後悔先に立たず
talk: 試験大丈夫かな	今まで頑張ってきたから大丈夫
talk: 試験範囲間違えてた	自分を信じて
talk: 話しかけるチャンス逃した	またチャンスあるよ
talk: 話しに割り込んでくる	一言声掛けたら？
talk: 話しを聞いてくれない	顔をこっちに向かせれば？
talk: 話を聞き逃した	もう一回聞きに行こう
talk: 誕生日プレゼント買い忘れた	気が付くことが大切
talk: 誤送信をしてしまった	一日以内なら送信取り消しできるよ
talk: 説明会に出忘れた	人生何とかなるさ！説明会に取り組んでいる君は頑張っている！
talk: 読んでた漫画が終了した	作者の次回作を待ちましょう
talk: 誰からもLINE来ない	私もだよ！
talk: 誰も観てくれない	神に愛されてるから大丈夫
talk: 課題あるけどドラマの続き見たい	ちょっとだけ見ちゃう？
talk: 課題[が|][わからない|分からない]	まずは友達に相談しよう
talk: 課題が全然[できない|解けない]	まずは友達に相談しよう
talk: 課題が同時にたくさん出た	無理はしないでね
talk: 課題が多い	徹夜だ！！
talk: 課題が終わらない	徹夜だ！！
talk: 課題が終わらなくて徹夜した	パチパチ！提出忘れないでね
talk: 課題[が|]難しい	簡単という人はいないよ
talk: 課題[が|]難しすぎる	簡単という人はいないよ
talk: 課題のやる気[が|]出ない	頑張れ！
talk: 課題の提出日まで課題をやる日がない	徹夜だ！！
talk: 課題の提出時間に間に合わなかった	次から遅れないようにすれば大丈夫だよ!
talk: 課題の期限を間違えた	やっちゃったね、、
talk: 課題の締め切り忘れてた	やっちゃったね、、
talk: 課題の締め切り間違えてた	やっちゃったね、、
talk: 課題を出し忘れた	説得して提出させてもらおう
talk: 課題を提出し忘れた	説得して提出させてもらおう
talk: 調味料入れる順番間違えた	次はうまくやれるよ
talk: 講義動画見忘れた	1回くらいなら大丈夫だよ
talk: [お|]財布[|を]忘れた	愉快なサザエさん♪
talk: [お|]財布[|を]無くした	クレカ止めて！
talk: [お|]財布[を|]落とした	クレカ止めて！
talk: 貢がせてくれない	正しい方向なの？
talk: 貯金できるかな	貯金箱買おう
talk: 買い忘れしちゃった	忘れないよう今度はメモしよう！
talk: 買い物で一個買い忘れた	家にあるもので試行錯誤してみよう
talk: 買うもの[|を]間違えた	届いてすぐなら返品できるから大丈夫だよ!
talk: [買ったばかりの|]ネックレス[を|]なくした	それは悲しいね
talk: 賞味期限[|が]切れていた	買ったらすぐ食べよう
talk: 赤信号ばっかり！	そんな日もある！
talk: 赤切れで手が痛い	保湿保湿！
talk: 起きたら午後だった	切り替えていこ
talk: 起きれるか不安	目覚まし時計をかけよう
talk: 足[が|]つった	痛いよね
talk: 足[を|]捻った	気をつけてね
talk: 足[を|]踏まれた	なんそいつ
talk: 身内が亡くなった	ご愁傷様です
talk: 身内に裏垢ばれたかも	それは仕方ないかも
talk: 身長[が|]伸びない	カルシウムとろう
talk: 車にぶつかられた	整骨院か病院通えばお金もらえるよ
talk: 車に煽られた	落ち着いて離れよう
talk: 車[|を]擦った	一度は経験する道
talk: 転んだ	大丈夫？怪我はない？
talk: 転んでズボンが破けた	ええええええぇ！？どんな状況？？！
talk: 辛い	お互いがんばろう！
talk: 辛すぎる	いけるて
talk: 迎えに誰も来てくれない	待ちぼうけの練習だ
talk: 近所のラーメン屋[|が]潰れた	他店に食べに行こう
talk: [近所の|]人に見られてる気がする	話してみたいと思われてるのかもしれない
talk: 返信[が|]こない	相手も忙しいんだよ
talk: 返信[が|]遅い	きっと相手も忙しいんだ…！
talk: 返信に時間が取られる	大事なメッセージだけ返せばいいよ
talk: 返信[が|]めんどくさい	代わりにやってあげる
talk: 返信[が|]途切れた	気にしない気にしない
talk: 迷子になった	近くの人に道聞いたら何とかなる！
talk: 迷惑メール	無視無視！
talk: 逃げたい	逃げるは恥だが役に立つ！
talk: 逃した	魚は大きい
talk: 逆向きの電車に乗った	冒険だ
talk: 連絡[するの|をし]忘れた	謝罪連絡しよう
talk: 連絡ミスをした	謝罪連絡しよう
talk: 連絡先きくの忘れた	運命の人だったかもね
talk: 進学どうしよう	先輩や先生に相談しよう
talk: 進路[が|]決まらない	よく考えよう
talk: 進路に迷う	自分を信じて！どの選択でも君次第！
talk: 遅刻しそう	ゆっくりおいで
talk: 遊びたい	やることやって遊んだらええ。
talk: 遊びに行く日に雨が降った	雨の日しかできないこと考えよ
talk: 遊びに行けない	お金貯めて収まったら遊びに行こう！
talk: 遊ぶ予定がなくなった	また今度会えるよ
talk: 遊んでいると帰りたくなくなる	楽しいもんね
talk: 運転が上手くならない	マリオカートで練習しよ！
talk: 道がわからない	ググって
talk: 道がわからなくなった	ググって
talk: 道が暗くて不気味	危険！
talk: 道に迷った	ググって
talk: 遠くの人の足元まで消しゴムが転がった	後で取りに行こう…
talk: 遠出してないな	年末だしどっか行っちゃおうよ
talk: 遠回しに悪口を書かれた	無視しな
talk: 部屋[|が]汚い	掃除しよう
talk: [部屋に|]ゴキブリが出た	怖すぎ
talk: 部屋に虫がいる	怖すぎ
talk: 部屋の電気消さずに家でちゃった	あるある
talk: 部屋中がニンニクくさい	何食べたん？？
talk: 部屋汚い	片付けよう！
talk: 部屋番号を間違えた	あら、ドジっ子ちゃん〜
talk: 部屋着の上から服を着た	たまにあるね
talk: 郵便[が|]届かない	気長に待ってみよう
talk: 酔っ払いに絡まれた	上手くかわそう
talk: 重い仕事を任せられる	君ならできる
talk: 野菜が値上げした	今年は不作だったのかね
talk: 野菜[|が]嫌い	無理しない程度に慣れよう
talk: 金遣いが荒い	気をつけなきゃね
talk: 録画してない	親に連絡しよ
talk: 録画[|を]忘れた	YouTubeとかで見られるよ
talk: 鍵[|を]しめ忘れた	早めに帰ろう
talk: 鍵をかけ忘れたかも…	ゆっくり自分の行動を思い出して
talk: 鍵[|を]なくした	一緒に探そうか
talk: 鍵[|を]忘れた	忘れないように玄関に置こう
talk: 長引いた	その分勉強できるね
talk: 間に合わなかった	まだ待ってるかも
talk: 間違えて資料消しちゃった	次はいいの作れるよ
talk: 間違えて送っちゃった	そういうこともあるよ
talk: 限界まで働いている	無理しちゃだめだよ
talk: 陰口を言われた	気にしちゃだめだよ！
talk: 階段から落ちた	七転び八起き
talk: 階段で転んだ	七転び八起き
talk: 階段を上るだけで息切れする	もうそんな歳なの？
talk: 階段[が|]辛い	いい運動になるね
talk: 集中力[が|]ない	好きなものじゃないと難しいね
talk: 集中力[が|]続かない	好きなものじゃないと難しいね
talk: 集合時間[が|]わからない	聞いてみよう
talk: 集合時間[が|]早すぎ	早起きは三文の徳
talk: 雇ってくれる会社あるかな	たぶんある
talk: 難しいことが出来ない	わかる、
talk: 雨[が|]降ってきた	傘ある？
talk: [雨で|]イベントが中止になる	楽しみにしてたのにね、、
talk: 雨で服が濡れた	わかる！
talk: 雨で洗濯ができない	晴れないかね
talk: 雨なのにバイトある…	頑張って✧＼ ٩(•́ι_•̀ )و ／✧
talk: 雨に[濡れた|降られた]	風邪ひかないように！
talk: 電気をつけっぱなしにした	次気をつければいいんだよ
talk: 電話も出ない	少し時間をおこう
talk: 電車[が|]止まった	予定狂うね
talk: 電車[が|]止まって帰れない	予定狂うね
talk: 電車[が|][遅れている|遅延してる]	予定狂うね
talk: 電車で貧血になった	それは辛い
talk: 電車に乗り遅れた	乗り換えでダッシュ！
talk: 電車に乗り間違えた	新しい旅の始まり！
talk: 電車に傘を忘れた	しょうがないよ
talk: 電車に間に合わなかった	乗り換えでダッシュ！
talk: 電車の時間に間に合わなかった	乗り換えでダッシュ！
talk: 電車[を|]間違えた	慌てないで確認しよう！
talk: 電車[を|]乗り過ごした	あるあるだわ
talk: 面接[|に受かっているか]心配	いい結果くるよ！
talk: 面接[が|]むずかった	いい結果くるよ！
talk: 面接官[が|]怖かった	どんな感じ？
talk: 靴下[が|]左右で違った	新しい靴下買っちゃお！
talk: 靴下[が|]バラバラだった	それはそれであり
talk: 靴擦れした	カットバン派？絆創膏派？
talk: 靴[|が]汚れた	洗えばいい
talk: 韓国[に|]行きたい	コロナ収まれー
talk: 音漏れしてた	そういうときもあるさ
talk: 頭[が|]痛い	パソコンの見過ぎなんじゃない？
talk: 頭痛が痛い	頭痛が痛いってっ！あんた…
talk: 顔が汚れて力が出ない	新しい顔だよ！(⚈ ⚈͜ ⚈)彡
talk: 風が吹いていて寒い	冬だね～
talk: 風邪かも	お大事に
talk: 風邪[が|]治らない	無理しないで
talk: 風邪[|を]ひいた	お大事に
talk: 飛行機乗り遅れた	仕方ないからリカバリしていこう
talk: 食べたいものが多すぎて辛い	運動すれば大丈夫
talk: 食べたものが消費期限切れだった	変な味しなかった？
talk: 食べられないものがある	それだけ残そう
talk: 食べ過ぎた	運動すれば大丈夫
talk: 食パンかじって出かけたら角で人とぶつかった	漫画家よ！！！
talk: 食材[を|]買い忘れた	でもその食材が欠けていても美味しいでしょ？
talk: 飲み物[を|]こぼした	パソコンにかけないで
talk: 馬が合わない人がいる	それが人生
talk: 馬鹿にされた	馬鹿にされるだけ愛嬌がある
talk: 骨折した	お大事に
talk: 高級パンケーキ[|を]焦がした	ぴえん越えてぱおん
talk: 髪の毛染めたら変な色にされた	その美容院には2度と行かないようにしよう
talk: 髪色[が|]決まらない	ブロンドがおすすめ
talk: 魚を逃した	逃した魚は大きいぞ！
talk: 鳥のフンがかかった	マジ萎えるよねぇ
talk: 鼻水[が|]止まらない	今日は寒いね
talk: [購入の|]予約を忘れた	買えることを祈ろう！
